{
  "village": {
    "name": "🏘️ Peaceful Village",
    "width": 20,
    "height": 15,
    "tileSize": 40,
    "encounterRate": 0.08,
    "nextMap": "forest",
    "bossId": null,
    "playerStart": [10, 7],
    "tiles": [
      [1,1,1,1,1,1,1,1,1,1,1,1,1,1,1,1,1,1,1,1],
      [1,2,2,2,1,2,2,2,2,2,2,2,2,2,1,2,2,2,2,1],
      [1,2,2,2,1,2,2,2,2,2,2,2,2,2,1,2,2,2,2,1],
      [1,2,2,2,1,2,2,3,3,2,2,3,3,2,1,2,2,2,2,1],
      [1,1,1,1,1,2,2,3,3,2,2,3,3,2,1,1,1,1,1,1],
      [1,2,2,2,2,2,2,2,2,2,2,2,2,2,2,2,2,2,2,1],
      [1,2,2,2,2,2,2,2,2,2,2,2,2,2,2,2,2,2,2,1],
      [1,2,2,2,4,4,2,2,2,2,2,2,2,4,4,2,2,2,2,1],
      [1,2,2,2,4,4,2,2,2,2,2,2,2,4,4,2,2,2,2,1],
      [1,2,2,2,2,2,2,2,2,2,2,2,2,2,2,2,2,2,2,1],
      [1,2,2,2,2,2,2,2,5,5,5,5,2,2,2,2,2,2,2,1],
      [1,2,2,2,2,2,2,2,5,5,5,5,2,2,2,2,2,2,2,1],
      [1,2,2,2,2,2,2,2,2,2,2,2,2,2,2,2,2,2,2,1],
      [1,14,14,1,1,1,1,1,1,1,1,1,1,1,1,1,1,1,1],
      [1,1,1,1,1,1,1,1,1,1,1,1,1,1,1,1,1,1,1,1]
    ],
    "npcs": [
      {"x": 7, "y": 3, "name": "Elder", "dialog": "Welcome, brave adventurer! The forest to the east holds dangerous creatures... but also treasures! Open chests for weapons!"},
      {"x": 11, "y": 3, "name": "Merchant", "dialog": "Looking for gear? Open chests scattered around the map for random weapons! Each weapon has unique skills!"},
      {"x": 9, "y": 10, "name": "Guard", "dialog": "The cave is beyond the forest. Only the strongest survive there... Be prepared!"}
    ],
    "chests": [
      {"x": 4, "y": 7, "opened": false, "gacha": true},
      {"x": 13, "y": 7, "opened": false, "gacha": true},
      {"x": 9, "y": 10, "opened": false, "gacha": true}
    ]
  },
  "forest": {
    "name": "🌲 Dark Forest",
    "width": 20,
    "height": 15,
    "tileSize": 40,
    "encounterRate": 0.15,
    "nextMap": "cave",
    "bossId": 10,
    "playerStart": [1, 7],
    "tiles": [
      [1,1,1,1,1,1,1,1,1,1,1,1,1,1,1,1,1,1,1,1],
      [1,6,6,6,6,6,1,2,2,2,2,2,1,6,6,6,6,6,6,1],
      [1,6,7,6,6,6,1,2,2,2,2,2,1,6,6,6,7,6,6,1],
      [1,6,6,6,6,6,1,2,2,2,2,2,1,6,6,6,6,6,6,1],
      [1,1,1,1,1,1,1,2,2,2,2,2,1,1,1,1,1,1,1,1],
      [1,6,6,6,6,2,2,2,2,2,2,2,2,2,6,6,6,6,6,1],
      [1,6,6,6,6,2,2,6,6,2,2,6,6,2,6,6,6,6,6,1],
      [1,6,6,6,6,2,2,6,6,2,2,6,6,2,6,6,6,6,6,1],
      [1,6,6,6,6,2,2,6,6,2,2,6,6,2,6,6,6,6,6,1],
      [1,6,6,6,6,2,2,2,2,2,2,2,2,2,6,6,6,6,6,1],
      [1,6,6,6,6,2,2,2,13,13,13,13,2,2,6,6,6,6,6,1],
      [1,6,6,6,6,2,2,2,13,13,13,13,2,2,6,6,6,6,6,1],
      [1,6,6,6,6,6,6,2,2,2,2,2,2,6,6,6,6,6,6,1],
      [1,14,14,1,1,1,1,1,1,14,14,1,1,1,1,1,1,1,1],
      [1,1,1,1,1,1,1,1,1,1,1,1,1,1,1,1,1,1,1,1]
    ],
    "npcs": [],
    "chests": [
      {"x": 7, "y": 1, "opened": false, "gacha": true},
      {"x": 16, "y": 1, "opened": false, "gacha": true}
    ]
  },
  "cave": {
    "name": "⛰️ Shadow Cave",
    "width": 20,
    "height": 15,
    "tileSize": 40,
    "encounterRate": 0.20,
    "nextMap": null,
    "bossId": 11,
    "playerStart": [10, 13],
    "tiles": [
      [1,1,1,1,1,1,1,1,1,1,1,1,1,1,1,1,1,1,1,1],
      [1,10,10,10,10,10,10,10,10,10,10,10,10,10,10,10,10,10,10,1],
      [1,10,10,11,10,10,10,10,10,10,10,10,10,10,10,11,10,10,10,1],
      [1,10,10,10,10,10,10,12,12,10,10,12,12,10,10,10,10,10,10,1],
      [1,1,1,1,1,10,10,12,12,10,10,12,12,10,10,1,1,1,1,1],
      [1,10,10,10,10,10,10,10,10,10,10,10,10,10,10,10,10,10,10,1],
      [1,10,10,10,10,10,10,10,10,13,13,10,10,10,10,10,10,10,10,1],
      [1,10,10,10,10,10,10,10,10,13,13,10,10,10,10,10,10,10,10,1],
      [1,10,10,10,10,10,10,10,10,10,10,10,10,10,10,10,10,10,10,1],
      [1,1,1,1,10,10,10,10,10,10,10,10,10,10,10,1,1,1,1,1],
      [1,10,10,10,10,10,10,12,12,10,10,12,12,10,10,10,10,10,10,1],
      [1,10,10,10,10,10,10,12,12,10,10,12,12,10,10,10,10,10,10,1],
      [1,10,10,10,10,10,10,10,10,10,10,10,10,10,10,10,10,10,10,1],
      [1,10,10,10,10,10,10,10,10,9,9,10,10,10,10,10,10,10,10,1],
      [1,1,1,1,1,1,1,1,1,1,1,1,1,1,1,1,1,1,1,1]
    ],
    "npcs": [],
    "chests": [
      {"x": 3, "y": 2, "opened": false, "gacha": true},
      {"x": 15, "y": 2, "opened": false, "gacha": true},
      {"x": 9, "y": 6, "opened": false, "gacha": true}
    ]
  }
}
